1111111111111111111111111111111111111111111111111111
1E00000000000000000CC0000000000000000000000000000001
100000CC00000000000000000000000000000000000000000001
1000000000000000000000000000000000000000000000000001
1000000000000000000000000000000000000000000000000001
1000000000000000000000000000000000000000000000000001
1000000000000000000000000000000000000C00000000000001
1000000000000000000000000000000000000000000000000001
1000000000000000000000000000000000000000000000000001
1000000000000000000000000000000000000000000000000001
1000000C00000000000000011110000000000000000000000001
1000000000000000000000010010000000000000000000000001
1000000000000000000000010010000000000000000000000001
1000000000000000000000011110000000000000000000000001
1000000000000000000000000000000000000000000000000001
1000000000000000000000000000000000000000000000000001
100000000000000C000000000000000000000C00000000000001
1000000000000000000000000000000000000000000000000001
1000000000000000000000000000000000000000000000000001
100000000000000000000000000C000000000000000000000001
1000000000000000000000000000000000000000000000000001
1000000000000000000000000000000000000000000000000001
1000000000000000000000000000000000000000000000000001
1000000000000000000000000000000000000000000000000001
1000000C00000000000000000000000000000000000000000001
100000000000000000000000C000000000000C00000000000001
1000000000000000000000000000000000000000000000000001
1000000000000000000000000000000000000000000000000001
10000000000C0000000000000000000000000000000000000001
10000000000000000000000000000000000000000000000000P1
1000000C00000000000000011110000000000000000000000001
1000000000000000000000010010000000000000000000000001
1000000000000000000000010010000000000000000000000001
1000000000000000000000011110000000000000000000000001
1000000000000000000000000000000000000000000000000001
1000000000000000000000000000000000000000000000000001
100000000000000C000000000000000000000C00000000000001
1000000000000000000000000000000000000000000000000001
100000000000000000000000C000000000000C00000000000001
1000000000000000000000000000000000000000000000000001
1111111111111111111111111111111111111111111111111111
