11111111
1E111111
1P101111
1C111111
11111111
